11111111111111111111
100000000000000000E1
10101111111001100001
10101000111001111001
1000000P0010001C0001
11111111111111111111
