11111111111111111
100000000C00000E1
10000000000011101
1000P000000000001
10000110001111111
100000000C0000001
11111111111111111