11111111111111111111111111111111
11P000000C1000000000000000000001
10101111111001111111111111111111
10101000000011111000000000000001
10000000000001111111111111111111
1111000000000000C000000000000001
10000000000000000000U00000000001
101010000000111110000000E0000001
10101000000011111000000000000001
10101000000011111000000000000001
10101000000011111000000C00000001
1010100U00001111100000000000U001
10101000000011111000000000000001
10101000000011111000000100000001
100000000U0000000000001C00000001
10000000000000000000000100111111
11111111111111111111111111111111