11111111111111111111111111111111
10P000000C1000000000000000000001
10101111111001111111111111111111
10101000000011111000000000000001
10000000000001111111111111111111
1111000000000000C000000000000001
10000000000000000000000000000001
101010000000111110000000E0000001
10101000000011111000000000000001
10101000000011111000000000000001
10101000000011111000000C00000001
10101000000011111000000000000001
10101000000011111000000000000001
10101000000011111000000000000001
10000000000000000000000C00000001
10000000000000000000000000111111
11111111111111111111111111111111