11111111111111111111111111111111
1000000000000000000000000000C001
10000000000000000000000000000001
10000000000000000000000000000001
10000000UUUUUUUUUUUUUUUUUUUU0001
10000000000000000000000000000001
10000000000000000000000000000001
10000000000000000000000000000001
1UUUUUUUUUUUUUUUUUUUUUUUUUUUUUU1
10000000000000000000000000000001
10000000000000000000000000000001
1000000000000P000000000000000001
10000000000000000000000000000001
10000UUUUUUUUU00000000UU00000001
10000000UUUUUUUUUUUUUUUU00000001
1000000000000000000000000000E001
11111111111111111111111111111111