11111111111111111111111111111111
100000000C1000000000000000000001
10101111111001111111111111111111
1010100000C011111000000000000001
10C0000P000001111111111111111111
11110000000000000000000000000001
10000000000000000000000000000001
1010100000C0111110000000E0000001
1010100000C011111000000000000001
1010100000C011111000000000000001
1010100000C011111000000000000001
1010100000C011111000000000000001
1010100000C011111000000000000001
1010100000C011111000000000000001
10000000000000000000000000000001
10000000000000000000000000111111
11111111111111111111111111111111