11111111111111111111
100000000000000001E1
10101111111000000001
10101000000000000001
1000000P0000000C0001
11111111111111111111