11111111111111111111111111111111
1PCCCCCCCCCCCCCCCCCCCCCCCCCCCCC1
1CCCCCCCCCCCCCCCUCCCUCCCCCCCCCC1
1CCCCCCCCCCCCCCCCCCCCCCCCCCUUUU1
1CCCCCCCCCCCCCCCCCCCCCCCCCCCCCC1
1CCCCCCCCCCCCCCCCCCCCCCCCCCCCCC1
1CCCCCCCCCCCCCCCCCCCCCCCCCCCCCC1
1CCCCCCCCCCCCCCCCCCCCCCCCCCCCCC1
1CCCCCCCCCCCCCCCCCCCCCCCCCCCCCC1
1CCCCCCCCCCCCCCCCCCCCCCCCCCCCCC1
1CCCCCCCCCCCCCCCCCCCCCCCCCCCCCC1
1CCCCCCCUCCCCCCCCCCCCUCCCCCCCCC1
1CCCCCCCCCCCCCCCCCCCCCCCCCCCCCC1
1CCUCCCCCCCCCCCCCCCCCCCCCCCCCCC1
1CCCCCCCCCCCCCCCCCCCCUCCCCCCCCC1
1CCCCCCCECCCCCCCCCCCCCCCCCCCCCC1
11111111111111111111111111111111