11111111111111
1C0000000C0001
10101111111001
10101000E0C011
10C0000P000001
11111111111111