11111111111111111111
10000000000000000101
10101111111000000001
10101000E00000000001
1000000P0000000C0001
11111111111111111111