11111111111111
10000C00000001
10101111111001
1010100CE00011
1000000P000001
11111111111111