111111111111
10000000P001
1111000000C1
100000000001
1E0000U00001
111111111111