111111111111
10000000P001
11110U0000C1
10U000000001
1E0000U000U1
111111111111