111111111111
10000000P001
11110U0000C1
1U0000000001
1CE00U000U01
111111111111